 	  NO     ./images/wood.xpm  	  
SO ./images/greystone.xpm
WE ./images/colorstone.xpm
EA ./images/mossy.xpm

F 74,41,41
C 231,236,249

        1111111111111111111111111
        1000000000110000000000001
        1011000001110000000000001
       1001000000000000000000001
111111111011000001110000000000001
100000000011000001110111111111111
11110111111111000000000011111
11110111111111011101010000001
11000000110101011100000010001
10000000000000001100000010001
10000000000000001101010010001
11000001110101011111011110N01
11110111 1110101 101111010001
11111111 1111111 111111111111
