  11 1   1111
  10101 1001
  1000011011
  100110N0001
110111111011
10000000001
1111111111
