NO ./images/wood.xpm
SO ./images/greystone.xpm
WE ./images/colorstone.xpm
EA ./images/mossy.xpm

F 74,41,41
C 231,236,249


1111      11111 1111
1001      1000011011
1001      100110N0001
1001 111011111101111
11111111111111111111111111111
1001    10000000001
1111    1111111111
