            111111111111111
          1100000000000000111
        11000000001000000001111
       1000000000011000000011111
      100000000000100000000111111
     10000000000000000000011111111
    1000000E00000000000011111111111
    1000000000000011111111111111111
     10000000000111111111111111111
      100000000111111111111111111
       1000000011111101111111111
        11000001111100011111111
          1100001111101111111
            111111111111111
