  11 1   1111 11
  10101  1   1001
  1000011011  11
  100110N0001
110111111011
10000000001
1111111111
