  11 1   11111111111111111111
  10101 1001   10000000000001
  1000011011   10000000000001
  100110N0001  10000000000001
110111111011   11111111111111
10000000001      111000111
1111111111        111111
