1001      11 1   1111
1001      10101 1001
1001      1000011011
1001      100110N0001
1001 a110111111011
1001    10000000001
1001    1111111111
