11 1 1111 11
101011111001
1000000001111
100110N0001
1101000001011
10000000001
1111111111
