NO ./images/wood.xpm
SO ./images/greystone.xpm
WE ./images/colorstone.xpm
EA ./images/mossy.xpm

C 231,236,249
F 74,41,41

            111111111111111
          1100000000000000111
        11000000001000000001111
       1000000000110E00000011111
      100000000000100000000111111
     10000000000000000000011111111
    1000000000000000000011111111111
    1000000000000011111111111111111
     10000000000111111111111111111
      100000000111111111111111111
       1000000011111101111111111
        11000001111100011111111
          1100001111101111111
            111111111111111
