  1111 11111
  10001000001
  1011000011
  100100N0001
110111111011
10000000001
1111111111
